1 1 1 1 1 1 1 1 1 1 1 1 1 1 1 1 1 1 1 1
1 3 5 4 0 0 0 0 0 0 0 1 1 1 1 0 0 4 5 1
1 0 1 1 1 1 1 1 0 1 0 1 0 0 0 1 0 0 1
1 0 0 0 0 0 0 1 0 1 0 1 1 1 0 1 0 0 0 1
1 0 1 1 1 0 0 1 0 1 0 0 0 0 0 1 0 0 1
1 0 0 0 1 4 4 1 0 1 0 1 0 1 1 1 0 0 0 1
1 0 1 0 1 1 1 1 0 1 0 0 0 0 0 0 0 0 0 1
1 0 0 0 0 0 0 0 2 1 
1 1 1 1 1 1 1 1 1 1 1 1 1 1 1 1 1 1 1 1